100000000000000000000000000000000010000001
100000000011111000000000000000111110000001
100000011100000000000000000000000000000001
100000000000000000110000110000000000000001
100000000000000000000000000000000000000001
100001100110000000000000000000000000000001
100000000000000000000000000000000000000001
100000000000000000000000000000000000000001
100000000000111000000000000000000000000001
111111111111111111111111111111111111111111